XXXXXXXXXXXXXXXXXXXXXXXXXXXXXXXXXXXXXXXXXXXXXXXXXXXXXXXXXXXXXXXXXXXXXXXXXXXXXX
X1111111111111111111111111133333324111112424111111111111111111111421422222222X
X2111111111111a21211111111111111111411111111111111111113111111111113131111111X
XXXXXXXXXXXXXXXXXXXXXXXXXXXXXXXXXXXXXXXX22222222222222123111XXXXXXXXXXXXXXXXXX
XXXXXXXXXXXXXXXXXXXXXXXXXXXXXXXXXXXXXXXXXXXXXXXXXXX221234111XXXXXXXXXXXXXXXXXX
XXXX11111111111111111111213411111111111111111111111111XXX1X1XXXXXXXXXXXXXXXXXX
XXXX11111111111111111111111111111111111111111111111111XXX1X2XXXXXXXXXXXXXXXXXX
XXXX22222222222222222222222222222222222222222222222222XXX1X5XXXXXXXXXXXXXXXXXX
XXXXXXXXXXXXXXXXXXXXXXXXXXXXXXXXXXXXXXXXXXXXXXXXX3XXXXXXXXbXXXXXXXXXXXXXXXXXXX
XXX11111111111111111111111111111111111111111111111111111113XXXXXXXXXXXXXXXXXXX
XXX1111111111111111111111111111111111111111111111111111111cXXXXXXXXXXXXXXXXXXX
XXX11111111111111111111111111111111121212121212121332424242XXXXXXXXXXXXXXXXXXX
XXXXXXXXXXXXXXXXXXXXXXXXXXXXXXXXXXXdXXXXXXXXXXXXXXXXXXXXXXXXXXXXXXXXXXXXXXXXXX
XXXXXXXXXXXXXXXXXXXXXXXXXXXXXXXXXXXXXXXXXXXXXXXXXXXXXXXXXXXXXXXXXXXXXXXXXXXXXX
