XXXXXXXXXXXXXXXXXXXXXXXXXXXXXXXXXXXXXXXXXXXXXXXXXXXXXXXXXXXXXXXXXXXXXXXXXXXXXX
X11111111111111*******1111133333324*****2424111111111111111111111421422222222X
X2111111111111*2121111*************41111**********111113111111111113131111111X
XXXXXXXXXXXXXXXXXXXXXXXXXXXXXXXXXXXXXXXX2222222222*222123111XXXXXXXXXXXXXXXXXX
XXXXXXXXXXXXXXXXXXXXXXXXXXXXXXXXXXXXXXXXXXXXXXXXXXX*21234111XXXXXXXXXXXXXXXXXX
XXXX11111111111111111111213411111111111111111111111*11XXX1X1XXXXXXXXXXXXXXXXXX
XXXX1111111111111111111111111111111111111111111111*111XXX1X2XXXXXXXXXXXXXXXXXX
XXXX222222222222222222222222222222222222222222222*2222XXX1X5XXXXXXXXXXXXXXXXXX
XXXXXXXXXXXXXXXXXXXXXXXXXXXXXXXXXXXXXXXXXXXXXXXXX*XXXXXXXXbXXXXXXXXXXXXXXXXXXX
XXX1111111111111111111111111111111111************1111111113XXXXXXXXXXXXXXXXXXX
XXX111111111111111111111111111111111*111111111111111111111cXXXXXXXXXXXXXXXXXXX
XXX11111111111111111111111111111111*21212121212121332424242XXXXXXXXXXXXXXXXXXX
XXXXXXXXXXXXXXXXXXXXXXXXXXXXXXXXXXX*XXXXXXXXXXXXXXXXXXXXXXXXXXXXXXXXXXXXXXXXXX
XXXXXXXXXXXXXXXXXXXXXXXXXXXXXXXXXXXXXXXXXXXXXXXXXXXXXXXXXXXXXXXXXXXXXXXXXXXXXX

