111111111111111111111111111111111111111111111111111111111111111111111111111111
111111111111111111111111111333333241111124241111111111111111111114214222222221
12111111111111*212111111111111111114111111111111111111131111111111131311111111
111111111111111*******11111111111111111122222222222222123111111111111111111111
1111111111111111111111******11111111111111111111111221234111111111111111111111
1111111111111111111111112134*1111111111111111111111111111111111111111111111111
11111111111111111111111111111*111111111111111111111111111112111111111111111111
111122222222222222222222222222*22222222222222222222222111115111111111111111111
1111111111111111111111111111111*11111111111111111311111111b1111111111111111111
11111111111111111111111111111111*111111111111111111111111131111111111111111111
111111111111111111111111111111111*111111111111111111111111c1111111111111111111
1111111111111111111111111111111111*1212121212121213324242421111111111111111111
11111111111111111111111111111111111*111111111111111111111111111111111111111111
11111111111111111111111111111111111111111111111111111111111111111111111111111x

